001
████████████████████████████████████████████████████████████████████████████████
█                                    █                                         █
█                     █              █                                         █
█    <                █              █                                         █
█               ███████              ██████████████                            █
█               █                                 █                            █
█               █                                 █                            █
█               █                                 █            >               █
█               █                                                              █
█               █                                 █                            █
█   █████████████  ████████████                   █                            █
█                                                 █                            █
█   █████████████  ████████████              ██████████████  ██                █
█               █  █          █              █               ██                █
█               █  █          █              █ ████████████  ██                █
█               █  █          █              █ █          █  ██                █
█               █             █              █ █  █       █  ██                █
█               █  █          █              █ █  █████████  ██                █
█               █  █          █              █               ██                █
████████████████████████████████████████████████████████████████████████████████
